################
#X     @V SO   #
# #            #
# #     G    # #
# # L   G    # #
# #     G    # #
# #     G    # #
# #          # #
# #          # #
# #   S      # #
# #          # #
# #   C      # #
# #          # #
# ############ #
#              #
################
